-1 -1 7 -1 6 6 6 -1 7 -1 10 8 10 -1 3 -1 -1 -1 5 0 4 7 -1 -1 -1 1 -1 -1 10 -1 
-1 -1 7 -1 7 4 5 4 -1 -1 -1 8 -1 -1 -1 -1 6 -1 -1 10 -1 7 -1 -1 -1 7 -1 -1 8 1 
7 7 -1 0 -1 -1 2 -1 8 -1 -1 0 10 -1 -1 -1 10 1 -1 -1 5 5 -1 -1 8 3 9 3 -1 2 
-1 -1 0 -1 -1 -1 -1 -1 -1 1 8 -1 9 -1 -1 -1 9 5 -1 3 4 -1 -1 -1 4 2 5 -1 -1 7 
6 7 -1 -1 -1 0 -1 8 6 -1 -1 8 -1 0 -1 2 10 -1 3 8 -1 10 5 -1 2 4 0 -1 2 -1 
6 4 -1 -1 0 -1 3 -1 -1 8 -1 0 -1 -1 5 7 0 -1 0 -1 5 -1 -1 7 -1 6 10 -1 -1 -1 
6 5 2 -1 -1 3 -1 -1 -1 -1 -1 4 4 2 -1 10 -1 -1 1 -1 0 -1 3 -1 10 -1 3 8 5 3 
-1 4 -1 -1 8 -1 -1 -1 -1 -1 -1 1 2 -1 -1 -1 -1 -1 -1 4 4 -1 -1 4 -1 8 -1 -1 -1 5 
7 -1 8 -1 6 -1 -1 -1 -1 5 2 1 -1 -1 -1 -1 2 -1 -1 0 4 -1 -1 -1 -1 5 -1 -1 5 2 
-1 -1 -1 1 -1 8 -1 -1 5 -1 0 -1 5 1 -1 10 -1 8 0 -1 4 1 6 9 2 -1 -1 7 9 1 
10 -1 -1 8 -1 -1 -1 -1 2 0 -1 -1 2 2 4 -1 -1 -1 -1 10 -1 1 2 8 9 -1 4 3 -1 -1 
8 8 0 -1 8 0 4 1 1 -1 -1 -1 -1 -1 1 8 8 -1 3 1 -1 1 -1 4 -1 4 -1 -1 -1 -1 
10 -1 10 9 -1 -1 4 2 -1 5 2 -1 -1 -1 7 -1 -1 10 9 -1 6 -1 -1 -1 -1 -1 -1 3 8 -1 
-1 -1 -1 -1 0 -1 2 -1 -1 1 2 -1 -1 -1 1 7 -1 -1 -1 -1 6 0 -1 -1 8 -1 10 3 -1 8 
3 -1 -1 -1 -1 5 -1 -1 -1 -1 4 1 7 1 -1 -1 8 -1 -1 0 -1 -1 -1 -1 -1 9 -1 -1 3 5 
-1 -1 -1 -1 2 7 10 -1 -1 10 -1 8 -1 7 -1 -1 1 -1 8 5 -1 -1 -1 3 -1 -1 10 0 -1 9 
-1 6 10 9 10 0 -1 -1 2 -1 -1 8 -1 -1 8 1 -1 9 -1 5 -1 2 -1 0 2 -1 -1 -1 7 -1 
-1 -1 1 5 -1 -1 -1 -1 -1 8 -1 -1 10 -1 -1 -1 9 -1 5 4 3 -1 10 -1 -1 2 -1 -1 4 -1 
5 -1 -1 -1 3 0 1 -1 -1 0 -1 3 9 -1 -1 8 -1 5 -1 -1 -1 -1 -1 -1 4 10 5 1 1 7 
0 10 -1 3 8 -1 -1 4 0 -1 10 1 -1 -1 0 5 5 4 -1 -1 -1 -1 7 6 3 9 -1 -1 5 10 
4 -1 5 4 -1 5 0 4 4 4 -1 -1 6 6 -1 -1 -1 3 -1 -1 -1 10 9 -1 8 -1 6 0 5 -1 
7 7 5 -1 10 -1 -1 -1 -1 1 1 1 -1 0 -1 -1 2 -1 -1 -1 10 -1 8 -1 -1 1 3 2 1 10 
-1 -1 -1 -1 5 -1 3 -1 -1 6 2 -1 -1 -1 -1 -1 -1 10 -1 7 9 8 -1 -1 -1 -1 4 4 4 8 
-1 -1 -1 -1 -1 7 -1 4 -1 9 8 4 -1 -1 -1 3 0 -1 -1 6 -1 -1 -1 -1 7 3 7 -1 7 7 
-1 -1 8 4 2 -1 10 -1 -1 2 9 -1 -1 8 -1 -1 2 -1 4 3 8 -1 -1 7 -1 -1 8 -1 -1 5 
1 7 3 2 4 6 -1 8 5 -1 -1 4 -1 -1 9 -1 -1 2 10 9 -1 1 -1 3 -1 -1 -1 -1 -1 5 
-1 -1 9 5 0 10 3 -1 -1 -1 4 -1 -1 10 -1 10 -1 -1 5 -1 6 3 4 7 8 -1 -1 5 0 -1 
-1 -1 3 -1 -1 -1 8 -1 -1 7 3 -1 3 3 -1 0 -1 -1 1 -1 0 2 4 -1 -1 -1 5 -1 -1 8 
10 8 -1 -1 2 -1 5 -1 5 9 -1 -1 8 -1 3 -1 7 4 1 5 5 1 4 7 -1 -1 0 -1 -1 -1 
-1 1 2 7 -1 -1 3 5 2 1 -1 -1 -1 8 5 9 -1 -1 7 10 -1 10 8 7 5 5 -1 8 -1 -1 
