-1 -1 -1 -1 -1 2 4 -1 1 -1 -1 -1 -1 3 -1 -1 -1 -1 -1 -1 8 9 2 4 -1 8 -1 1 -1 -1 
-1 -1 -1 -1 5 3 -1 1 -1 0 -1 -1 0 4 0 -1 -1 0 9 2 3 -1 -1 -1 -1 6 -1 0 8 -1 
-1 -1 -1 6 -1 -1 6 7 -1 -1 -1 6 -1 -1 -1 6 -1 -1 -1 9 9 -1 6 6 -1 -1 -1 10 -1 -1 
-1 -1 6 -1 10 2 7 6 -1 -1 -1 -1 -1 -1 1 -1 9 -1 9 -1 7 -1 -1 1 8 -1 7 4 7 6 
-1 5 -1 10 -1 -1 9 2 6 -1 8 5 4 -1 5 -1 -1 -1 5 -1 8 -1 -1 -1 0 -1 -1 -1 5 1 
2 3 -1 2 -1 -1 -1 -1 -1 7 7 10 5 -1 9 0 4 -1 9 -1 4 -1 10 9 -1 -1 1 -1 2 8 
4 -1 6 7 9 -1 -1 -1 0 -1 6 -1 -1 3 -1 -1 -1 2 8 -1 9 -1 -1 -1 -1 4 -1 -1 -1 5 
-1 1 7 6 2 -1 -1 -1 -1 -1 -1 0 -1 -1 5 8 -1 5 3 -1 6 10 -1 -1 9 0 3 10 7 5 
1 -1 -1 -1 6 -1 0 -1 -1 1 -1 2 -1 4 -1 -1 10 -1 -1 2 -1 7 2 -1 6 9 -1 7 0 9 
-1 0 -1 -1 -1 7 -1 -1 1 -1 4 1 1 0 5 0 5 7 -1 -1 -1 -1 -1 7 1 8 -1 8 -1 2 
-1 -1 -1 -1 8 7 6 -1 -1 4 -1 10 -1 1 2 -1 -1 -1 3 -1 0 -1 -1 -1 -1 -1 8 6 8 -1 
-1 -1 6 -1 5 10 -1 0 2 1 10 -1 8 1 6 10 5 1 0 2 -1 0 9 10 3 -1 0 0 0 0 
-1 0 -1 -1 4 5 -1 -1 -1 1 -1 8 -1 10 8 -1 6 8 -1 -1 -1 6 -1 0 -1 5 5 -1 7 -1 
3 4 -1 -1 -1 -1 3 -1 4 0 1 1 10 -1 -1 6 -1 10 -1 -1 -1 -1 3 1 -1 -1 1 0 -1 10 
-1 0 -1 1 5 9 -1 5 -1 5 2 6 8 -1 -1 -1 -1 -1 1 3 -1 7 3 5 -1 -1 -1 1 5 -1 
-1 -1 6 -1 -1 0 -1 8 -1 0 -1 10 -1 6 -1 -1 3 -1 10 7 -1 -1 -1 -1 -1 1 3 -1 -1 -1 
-1 -1 -1 9 -1 4 -1 -1 10 5 -1 5 6 -1 -1 3 -1 7 -1 6 -1 -1 -1 7 5 -1 5 -1 -1 -1 
-1 0 -1 -1 -1 -1 2 5 -1 7 -1 1 8 10 -1 -1 7 -1 -1 -1 3 10 -1 6 -1 -1 1 -1 4 -1 
-1 9 -1 9 5 9 8 3 -1 -1 3 0 -1 -1 1 10 -1 -1 -1 -1 6 -1 5 8 -1 -1 4 -1 -1 7 
-1 2 9 -1 -1 -1 -1 -1 2 -1 -1 2 -1 -1 3 7 6 -1 -1 -1 -1 -1 -1 10 -1 9 -1 -1 2 -1 
8 3 9 7 8 4 9 6 -1 -1 0 -1 -1 -1 -1 -1 -1 3 6 -1 -1 -1 -1 -1 0 5 2 -1 -1 -1 
9 -1 -1 -1 -1 -1 -1 10 7 -1 -1 0 6 -1 7 -1 -1 10 -1 -1 -1 -1 -1 4 4 -1 5 1 6 10 
2 -1 6 -1 -1 10 -1 -1 2 -1 -1 9 -1 3 3 -1 -1 -1 5 -1 -1 -1 -1 -1 9 -1 8 7 -1 -1 
4 -1 6 1 -1 9 -1 -1 -1 7 -1 10 0 1 5 -1 7 6 8 10 -1 4 -1 -1 -1 7 -1 8 -1 2 
-1 -1 -1 8 0 -1 -1 9 6 1 -1 3 -1 -1 -1 -1 5 -1 -1 -1 0 4 9 -1 -1 -1 0 -1 4 -1 
8 6 -1 -1 -1 -1 4 0 9 8 -1 -1 5 -1 -1 1 -1 -1 -1 9 5 -1 -1 7 -1 -1 -1 3 2 10 
-1 -1 -1 7 -1 1 -1 3 -1 -1 8 0 5 1 -1 3 5 1 4 -1 2 5 8 -1 0 -1 -1 5 10 -1 
1 0 10 4 -1 -1 -1 10 7 8 6 0 -1 0 1 -1 -1 -1 -1 -1 -1 1 7 8 -1 3 5 -1 -1 -1 
-1 8 -1 7 5 2 -1 7 0 -1 8 0 7 -1 5 -1 -1 4 -1 2 -1 6 -1 -1 4 2 10 -1 -1 -1 
-1 -1 -1 6 1 8 5 5 9 2 -1 0 -1 10 -1 -1 -1 -1 7 -1 -1 10 -1 2 -1 10 -1 -1 -1 -1 
