-1 -1 4 2 2 -1 -1 -1 2 -1 -1 7 1 -1 -1 -1 -1 10 -1 3 -1 3 7 1 -1 9 8 1 5 0 
-1 -1 -1 4 9 -1 9 -1 0 3 7 -1 -1 9 -1 0 0 10 -1 1 9 2 6 -1 -1 -1 7 -1 5 9 
4 -1 -1 2 10 1 6 6 0 6 4 7 -1 -1 -1 -1 -1 4 -1 6 -1 10 -1 -1 2 -1 5 -1 0 4 
2 4 2 -1 -1 -1 10 2 -1 -1 -1 -1 0 2 1 -1 7 8 2 -1 -1 10 -1 -1 -1 -1 6 8 -1 3 
2 9 10 -1 -1 -1 4 8 3 -1 -1 10 6 3 -1 10 -1 -1 -1 -1 2 -1 -1 0 -1 10 1 -1 1 1 
-1 -1 1 -1 -1 -1 9 9 3 4 3 4 7 7 6 0 10 -1 -1 0 -1 7 -1 2 8 5 5 -1 4 10 
-1 9 6 10 4 9 -1 7 -1 -1 6 0 -1 10 -1 4 1 -1 -1 5 9 -1 -1 -1 1 3 6 -1 -1 4 
-1 -1 6 2 8 9 7 -1 1 -1 9 6 2 -1 -1 8 -1 10 -1 -1 10 6 8 5 3 1 -1 -1 3 -1 
2 0 0 -1 3 3 -1 1 -1 -1 -1 1 -1 0 -1 1 8 -1 -1 -1 -1 -1 -1 6 4 9 -1 8 -1 1 
-1 3 6 -1 -1 4 -1 -1 -1 -1 -1 -1 10 3 -1 -1 7 5 -1 9 -1 10 2 4 -1 -1 0 -1 3 1 
-1 7 4 -1 -1 3 6 9 -1 -1 -1 2 -1 -1 -1 10 0 -1 -1 -1 1 -1 -1 7 -1 0 -1 4 -1 0 
7 -1 7 -1 10 4 0 6 1 -1 2 -1 0 3 0 8 0 3 5 -1 7 3 6 -1 -1 -1 -1 2 5 -1 
1 -1 -1 0 6 7 -1 2 -1 10 -1 0 -1 10 3 5 -1 -1 3 -1 6 4 -1 -1 0 8 2 4 -1 -1 
-1 9 -1 2 3 7 10 -1 0 3 -1 3 10 -1 -1 10 -1 -1 -1 7 -1 4 7 4 5 -1 9 3 5 6 
-1 -1 -1 1 -1 6 -1 -1 -1 -1 -1 0 3 -1 -1 5 -1 -1 -1 1 -1 -1 6 7 7 -1 -1 8 -1 6 
-1 0 -1 -1 10 0 4 8 1 -1 10 8 5 10 5 -1 5 1 7 4 -1 -1 5 -1 -1 0 -1 -1 3 -1 
-1 0 -1 7 -1 10 1 -1 8 7 0 0 -1 -1 -1 5 -1 5 -1 -1 -1 1 -1 -1 -1 9 10 5 -1 -1 
10 10 4 8 -1 -1 -1 10 -1 5 -1 3 -1 -1 -1 1 5 -1 -1 -1 -1 2 -1 -1 1 -1 1 -1 8 5 
-1 -1 -1 2 -1 -1 -1 -1 -1 -1 -1 5 3 -1 -1 7 -1 -1 -1 -1 -1 4 4 -1 -1 5 -1 -1 -1 -1 
3 1 6 -1 -1 0 5 -1 -1 9 -1 -1 -1 7 1 4 -1 -1 -1 -1 6 -1 1 -1 9 -1 -1 1 1 -1 
-1 9 -1 -1 2 -1 9 10 -1 -1 1 7 6 -1 -1 -1 -1 -1 -1 6 -1 -1 -1 -1 0 4 -1 10 -1 -1 
3 2 10 10 -1 7 -1 6 -1 10 -1 3 4 4 -1 -1 1 2 4 -1 -1 -1 3 -1 -1 4 -1 -1 4 0 
7 6 -1 -1 -1 -1 -1 8 -1 2 -1 6 -1 7 6 5 -1 -1 4 1 -1 3 -1 -1 1 10 8 -1 -1 -1 
1 -1 -1 -1 0 2 -1 5 6 4 7 -1 -1 4 7 -1 -1 -1 -1 -1 -1 -1 -1 -1 -1 -1 0 -1 -1 -1 
-1 -1 2 -1 -1 8 1 3 4 -1 -1 -1 0 5 7 -1 -1 1 -1 9 0 -1 1 -1 -1 8 2 3 8 -1 
9 -1 -1 -1 10 5 3 1 9 -1 0 -1 8 -1 -1 0 9 -1 5 -1 4 4 10 -1 8 -1 -1 -1 9 10 
8 7 5 6 1 5 6 -1 -1 0 -1 -1 2 9 -1 -1 10 1 -1 -1 -1 -1 8 0 2 -1 -1 -1 2 5 
1 -1 -1 8 -1 -1 -1 -1 8 -1 4 2 4 3 8 -1 5 -1 -1 1 10 -1 -1 -1 3 -1 -1 -1 -1 -1 
5 5 0 -1 1 4 -1 3 -1 3 -1 5 -1 5 -1 3 -1 8 -1 1 -1 4 -1 -1 8 9 2 -1 -1 1 
0 9 4 3 1 10 4 -1 1 1 0 -1 -1 6 6 -1 -1 5 -1 -1 -1 0 -1 -1 -1 10 5 -1 1 -1 
